1111111
1000001
1111111
1000001
1111111
1000001
1111111
1111111
1111111
1111111
1111111
1111111
1010101
0101010
1010101
0101010
1010101
0101010
1010101
1010101
1010101
1010101
1010101
1010101
1000001
1011101
1010101
1011101
1000001
1111111
1110111
1011101
1111111
1111111
1011101
1110111
