1111111
1000001
1111111
1000001
1111111
1000001
1010101
0101010
1010101
0101010
1010101
0101010
1010101
1010101
1010101
1010101
1010101
1010101
1000001
1011101
1010101
1011101
1000001
1111111
1110111
1011101
1111111
1111111
1011101
1110111
1010101
0101010
0010101
0101010
1010101
0101010
1111111
0101010
1111111
1111111
1010101
1111111
1010101
1111111
1010101
1010101
1111111
1010101
1111111
1111111
1110111
1110111
1111111
1111111
1011101
1100011
1110111
1110111
1100011
1011101
1110111
1010101
1010101
1010101
1010101
1110111
1111111
0111110
0011100
0001000
1101011
1001001
1110111
0111110
1111111
0111110
1111111
0110110
0111110
1110111
1101011
1101011
1110111
0111110
